20
15
11111111111111111111
00000000000000000000
11111111111111111111
00000000000000000000
11111111111111111111
00000000000000000000
11111111110000000000
11111111110000000000
11111111110000000000
11111111110000000000
11111111110000000000
11111111110000000000
01010101010101010101
10101010101010101010
01010101010101010101
